1 1 2 2 3 3
1 1 2 2 3 3
2 2 4 4 6 6
2 2 4 4 6 6
1 1 2 2 0 3
1 1 2 2 4 4